{
  "width": 10,
  "height": 8,
  "grid": [
    [1,1,1,1,1,1,1,1,1,1],
    [1,0,0,0,0,0,0,0,0,1],
    [1,0,1,0,1,0,1,0,1,1],
    [1,0,0,0,0,0,0,0,0,1],
    [1,1,1,1,1,1,1,1,1,1]
  ],
  "legend": {
    "0": "path",
    "1": "wall"
  }
}
